################################################################################################
################################################################################################
################################################################################################
################################################################################################
################################################################################################
################################################################################################
##################################..............................################################
##################################..............................################################
##################################..............................################################
##################################..............................################################
##################################..............>...............################################
##################################..............................################################
##################################..............................################################
##################################..............................################################
##################################..............................################################
##################################..............................################################
##################################..............................################################
##################################..............................################################
##################################..............................################################
##################################..............................################################
################################################...#############################################
################################################...#############################################
################################################...#############################################
################################################...#############################################
################################################...#############################################
################################################...#############################################
################################################...#############################################
################################################...#############################################
################################################...#############################################
################################################...#############.....................###########
################################################...#############.....................###########
################################################...#############.....................###########
################################################...#############.....................###########
##############.........................#########...#############.....................###########
##############.........................#########...#############.....................###########
##############.........................#########...#############.....................###########
##############.........................#########.....................................###########
##############.......+.................##................................+...........###########
##############.........................##............................................###########
##############.........................##.....................##.....................###########
##############................................................##.....................###########
##############................................................##.....................###########
##############................................................##.....................###########
##############.........................##.....................##.....................###########
##############.........................##.....................##.....................###########
##############.........................##.....................###########...####################
##############.........................##...................................####################
##############.........................##...................................####################
##############.........................##..................................#####################
#########################...#############.....................##################################
#########################...#############.....................##################################
#########################...#############.....................##################################
#########################...#############.....................##################################
#########################...#############.....................##################################
#########################...#############.....................##################################
#########################...#############.....................##################################
#########################...#############.....................##################################
###########...........................###.....................##################################
###########...........................###.....................##################################
###########...........................###########...#####.......................################
###########...........................###########...#####.......................################
###########...........................###########...#####..~~~~~~~~~~~~~~~.~~...################
###########...........................###########...#####..~~~~~~~~~~~~~~~~~~...################
###########...........................###########...#####..~~~~~~~~~~~~~~~~~~...################
###########.........................................#####..~~~~~~~~~~~~~~~~~~...################
###########................................................~~~~~~~~~~~~~~~~~~...################
###########................................................~~~~~~~~~~~~~~~~~~...################
###########...........................############.........~~~~~~~~~~~~~~~~~~...################
###########...........................###################..~~~~~~~~~~~~~~~~~....################
###########...........................###################..~~~~~~~~~~~~~~~~.~...################
###########...........................###################..~~~~~~~~~~~~~~~.~~...################
###########...........................###################.......................################
###########...........................###################.......................################
#######################...#########################################...##########################
#######################...#########################################...##########################
#######################...#########################################...##########################
#######################...#########################################...##########################
#######################...#########################################...##########################
#######################...#########################################...##########################
#######################...#########################################...##########################
#######################...###########.........................#####...##########################
#######################...###########.........................#####...##########################
#######################...###########.........................#####...##########################
#######################...###########.........................#####...##########################
#######################...###########.........................#####...##########################
#######################...............................................##########################
#######################...............................................##########################
########################.............................................###########################
#####################################...........<.............##################################
#####################################.........................##################################
#####################################.........................##################################
#####################################.........................##################################
################################################################################################
################################################################################################
################################################################################################
################################################################################################
