################################################################################################
################################################################################################
################################################################################################
################################################################################################
################################################################################################
################################################################################################
################################################################################################
################################################################################################
#####################################################################....#................######
#####################################################################...#.................######
#####################################################################..#.................#######
#####################################################################.#.................#.######
######################################################################....................######
#####################################################################.....................######
#####################################################################.........>...........######
#####################################################################.....................######
#####################################################################.....................######
#####################################################################.....................######
#####################################################################.....................######
#####################################################################....................#######
#####################################################################.#.................#.######
######################################################################.................#..######
#####################################################################.................#...######
#####################################################################................#....######
##############################################################################...###############
#########################################.......................##############...###############
#########################################.......................##############...###############
#########################################.......................##############...###############
#########################################.......................##############...###############
#########################################.......................##############...###############
#########################################.......................##############...###############
#########################################.......................##############...###############
#########################################........................................###############
#########################################........................................###############
#########################################........................................###############
#########.#.....................................................##############...###############
##########......................................................##############...###############
#########.......................................................##############...###############
#########.......................................................##############...###############
#########.......................................................##############...###############
#########.......................................................##############...###############
#########................................................#####################...###############
#########................................................#####################...###############
#########...............................................######################...###############
#########................................................#####################...###############
#########................................................#####################...###############
#########................................................#####################...###############
#########.......................~~.~~~~~~~~~~~~~~~~~.~~~~~~###################...###############
#########.......................~.~~~~~~~~~~~~~~~~~~~~~~~~~###################...###############
#########........................~~~~~~~~~~~~~~~~~~~~~~~~~~###################...###############
#########.......................~~~~~~~~~~~~~~~~~~~~~~~~~~####################...###############
#########.......................~~~~~~~~~~~~~~~~~~~~~~~~~#~###################...###############
#########.......................~~~~~~~~~~~~~~~~~~~~~~~~#~~###################...###############
#########.#.....................~~~~~~~~~~~~~~~~~~~~~~~~~~~###################...###############
##########......................~~~~~~~~~~~~~~~~~~~~~~~~~~~###################...###############
#########.......................~~~~~~~~~~~~~~~~~~~~~~~~~~~###################...###############
#########.......................~~~~~~~~~~~~~~~~~~~~~~~~~~~###################...###############
#########......#................~~~~~~~~~~~~~~~~~~~~~~~~~~~###################...###############
#########.....#.................~~~~~~~~~~~~~~~~~~~~~~~~~~~###################...###############
#########....#..................~~~~~~~~~~~~~~~~~~~~~~~~~~~###################...###############
#####################...########~~~~~~~~~~~~~~~~~~~~~~~~~~~###################...###############
#####################...########~~~~~~~~~~~~~~~~~~~~~~~~~~~###################...###############
#####################...########~~~~~~~~~~~~~~~~~~~~~~~~~~~###################...###############
#####################...########~~~~~~~~~~~~~~~~~~~~~~~~~~~......................###############
#####################...########~~~~~~~~~~~~~~~~~~~~~~~~~~~.......................##############
#####################...########~~~~~~~~~~~~~~~~~~~~~~~~~~~.......................##############
#####################...########~~~~~~~~~~~~~~~~~~~~~~~~~~~.......................##############
#####################...########~~~~~~~~~~~~~~~~~~~~~~~~~~~.......................##############
#####################...########~~~~~~~~~~~~~~~~~~~~~~~~~~~.......................##############
#####################...########~~~~~~~~~~~~~~~~~~~~~~~~~~~.......................##############
#####################...########~~~~~~~~~~~~~~~~~~~~~~~~~~~.......................##############
#####################...########~~~~~~~~~~~~~~~~~~~~~~~~~~~.......................##############
#####################...########~~~~~~~~~~~~~~~~~~~~~~~~~~~......................###############
#####################...########~~~~~~~~~~~~~~~~~~~~~~~~~~~.....................#.##############
#####################...########~~#~~~~~~~~~~~~~~~~~~~~~~~~..#.................#..##############
#####################...########~#~~~~~~~~~~~~~~~~~~~~~~~~~#####################################
#####################...#########~~~~~~~~~~~~~~~~~~~~~~~~~~#####################################
#####################...########~~~~~~~~~~~~~~~~~~~~~~~~~~######################################
#####.......................####~~~~~~~~~~~~~~~~~~~~~~~~~#~#####################################
#####.......................####~~~~~~#~~~~~~~~~~~~~~~~~#~~#####################################
#####.......................##############...###################################################
#####......................###############...###################################################
#####.......................##############...###################################################
#####........................................###################################################
#####.........<..............................###################################################
#####.......................................####################################################
#####.......................####################################################################
#####.......................####################################################################
#####.......................####################################################################
#####.....#.................####################################################################
################################################################################################
################################################################################################
################################################################################################
################################################################################################
################################################################################################
################################################################################################
