################################################################################################
################################################################################################
################################################################################################
################################################################################################
##################################..............................################################
##################################..............................################################
##################################..............................################################
##################################..............................################################
##################################..............>...............################################
##################################..............................################################
##################################..............................################################
##################################..............................################################
##################################..............................################################
##################################..............................################################
##################################..............................################################
##################################..............................################################
##################################..............................################################
##################################..............................################################
#####################...............#..#########...#############################################
#####################..................#########...#############################################
#####################..................#########...#############################################
#####################..................#########...#############################################
#####################..................#########...#############################################
#####################..............................#############################################
#####################..............................#############################################
#####################...................................########################################
#####################..................................#.#######################################
#####################.................................#..#######################################
#####################................................#...#######################################
#####################....#........#......................#######################################
#############################...#######..................#######################################
#############################...#######..................#######################################
#############################...#######.#................#######################################
#############################...########.................#######################################
#############################...#######.................########################################
#############################...#######..................#######################################
#############################...#######..................#######################################
#############################...#######..................#######################################
#############################...#######..................#######################################
#########.......................#######..................#######.....#.................#########
#########.......................#######..................#######......................##########
#########.......................#######..................#######.....^^^^^^^^^^^^^^^^#.#########
#########.......................#######..................#######.....^^^^^^^^^^^^^^^...#########
#########.......................#######..................#######.....^^^^^^^^^^^^^^^^..#########
#########.......................#######..............................^^^^^^^^^^^^^^^^..#########
#########.......................#######..............................^^^^^^^^^^^^^^^^..#########
#########.......................#######..............................^^^^^^^^^^^^^^^^..#########
#########.......................#######..................#######.....^.^^^^^^^^^^^^^^..#########
#########.......................#######..................#######......^^^^^^^^^^^^^^^..#########
#########.......................#######..................#######......................##########
#########....#.................########..................#######...#.................#.#########
###################...#################..................#################...###################
###################...#################..................#################...###################
###################...#################..................#################...###################
###################...#################..................#################...###################
###################...#################..................#################...###################
###################...#################..................#################...###################
###########....#.................#..........................#.................#........#########
###########...#............................................#..........................##########
###########..#....^^^^^^^^^.............#.................#..........^^^^^^^^^^^.....#.#########
###########.#.....^^^^^^^^^............#.............................^^^^^^^^^^^.......#########
############......^^^^^^^^^..........................................^^^^^^^^^^^.......#########
###########.......^^^^^^^^^..........................................^^^^^^^^^^^.......#########
###########.......^^^^^^^^^...........................#..............^^^^^^^^^^^.......#########
###########.......^^^^^^^^...........................#...............^^^^^^^^^^^.......#########
###########............................................................................#########
###########............................................................................#########
###########............................................................................#########
###########.............................###############................................#########
###########............................#.##############................................#########
############..........................#..##############.#..........................#...#########
###########..........................#...###############..........................#....#########
###########.......#.................#....##############........#.................#.....#########
#######################...###########################################...########################
#######################...###########################################...########################
#######################...###########################################...########################
#######################...###########################################...########################
#######################...###########################################...########################
#######################...###########################################...########################
#######################...###########################################...########################
#######################...############.................#......#######...########################
#######################...###########.........................#######...########################
#######################...###########.........................#######...########################
#######################...###########........................########...########################
#######################...###########.........................#######...########################
#######################.................................................########################
#######################.................................................########################
########################...............................................#########################
#####################################...........<.............##################################
######################################........................##################################
#####################################.........................##################################
#####################################.........................##################################
################################################################################################
################################################################################################
################################################################################################
################################################################################################
