################################################################################################
################################################################################################
################################################################################################
################################################################################################
################################################################################################
################################################################################################
################################################################################################
################################################################################################
#######################################################################..#...............#######
#######################################################################.#................#######
########################################################################.................#######
#######################################################################.................########
#######################################################################..................#######
#######################################################################..................#######
#########....#................#########################################...........>......#######
#########...#.................#########################################..................#######
#########....................##########################################..................#######
#########.....................#########################################..................#######
#########..~~~~~~~~~~~~~~~~...#########################################..................#######
#########..~~~~~~~~~~~~~~~....##########################################.................#######
#########..~~~~~~~B~~~~~~~~.............................................................########
#########..~~~~~~~~~~~~~~~~............................................................#.#######
#########..~~~~~~~~~~~~~~~~...........................................................#..#######
#########..~~~~~~~~~~~~~~~~...#########################################..............#...#######
#########..~.~~~~~~~~~~~~~~...#################################################...##############
#########...~~~~~~~~~~~~~~~..##################################################...##############
#########.#.................#.#################################################...##############
##########.................#..#################################################...##############
##################...##########################################################...##############
##################...################################################..................#########
##################...################################################..................#########
##################...################################################..................#########
##################...################################################..................#########
##################...################################################..................#########
##################...################################################..................#########
##################...#############...#..........................#.###..................#########
##################...#############..#..........................#..###..................#########
##################...#############.#.~~~~~~~.~~~~~~~~~~~~~~~~~#~..###..................#########
##################...##############..~~~~~~~~~~~~~~~~~~~~~~~~.~~..###..................#########
##################...#############...~~~~~~~~~~~~~~~~~~~~~~~~~~~..###..................#########
##################...#############...~~~~~~~~~~~~~~~~~~~~~~~~~~~..###..................#########
##################...#############...~~~~~~~~~~~~~~~~~~~~~~~~~~~..###########...################
##################...#############...~~~~~~~~~~~~~~~~~~~~~~~~~~~..###########...################
##################...................~~~~~~~~~~~~~~~~~~~~~~~~~~~................################
##################...................~~~~~~~~~~~~~~~~~~~~~~~~~~~................################
###################..................~~~~~~~~~~~~~~~~~~~~~~~~~~~...............#################
##################################...~~~~~~~~~~~~~~~~~~~~~~~~~~~..##############################
###################################..~~~~~~~~~~~~~~~~~~~~~~~~~~~..##############################
##################################...~~~~~~~~~~~~~~~~~~~~~~~~~~~..##############################
##############################..#....~~~~.~~~~~~~~~~~~~~~~~.~~~~....#..#########################
##############################.#.....~~~.~~~~~~~~~~~~~~~~~.~~~~~...#...#########################
###############################...................................#....#########################
##############################...................................#.....#########################
##############################.........................................#########################
##############################.........................................#########################
##############################.........................................#########################
##############################........................................##########################
##############################.........................................................#########
##############################........................................................##########
##############################.......................................................#.#########
##############################.........................................................#########
##############################.........................................................#########
##############################.........................................................#########
##############################.........................................................#########
##############################.........................................................#########
##############################.........................................................#########
##############################.........................................................#########
##############################........................................................##########
##############################.#.....................................................#.#########
###############################.....................................................#..#########
##############################.....................................................#...#########
##############################.........................................#########################
##############################.........................................#########################
##############################.....#...................................#########################
###########################..................................#........##########################
###########################.................................#........#.#########################
######.................#..........................##############################################
#####............................................###############################################
#####.............................................##############################################
#####.............................................##############################################
#####.............................................##############################################
#####.............................................##############################################
#####.............................................##############################################
#####.............................................##############################################
#####......<......................................##############################################
#####...........................#.................##############################################
#####.......................####################################################################
#####.......................####################################################################
#####.......................####################################################################
#####.....#.................####################################################################
################################################################################################
################################################################################################
################################################################################################
################################################################################################
################################################################################################
################################################################################################
