################################################################################################
################################################################################################
################################################################################################
################################################################################################
################################################################################################
################################################################################################
##################################..............................################################
##################################..............................################################
##################################..............................################################
##################################..............................################################
##################################..............>...............################################
##################################..............................################################
##################################..............................################################
##################################..............................################################
##################################..............................################################
##################################..............................################################
##################################..............................################################
##################################..............................################################
##################################..............................################################
##################################..............................################################
###########.......................##############...#############################################
###########.......................##############...#############################################
###########.......................##############...#############################################
###########.......................##############...#############################################
###########.......................##############...#############################################
###########.......................##############...#############################################
###########........................................#############################################
###########........................................#############################################
###########........................................#############################################
###########.......................############^^^^^^############################################
###########.......................############^^^^^#^###########################################
###########.......................############^^^^^^^###########################################
###########.......................############^^^^^^^###########################################
###########.......................############^^^^^^^###########################################
#####################...######################^^^^^^^###########################################
#####################...#######################^^^^^^###########################################
#####################...######################^^^^^^^###########################################
#####################...########..............^^^^^^^.............##############################
#####################...########..............^^^^^^^.............##############################
#####################...########..............^^^^^^^.............##############################
#####################...########..............^^^^^^^.............##############################
#####################...########.........^^^^^^^^^^^^^^^^.........##############################
#####################...########.........^^^^^^^^^^^^^^^^.........##############################
#####################...########.........^^^^^^^^^^^^^^^..........##############################
#####################...########.........^^^^^^^^^^^^^^^^.........##############################
#####################...########.........^^^^^^^^^^^^^^^^.........##############################
#####################...########.........^^^^^^^^^^^^^^^^.........##############################
#####################...########.........^^^^^^^^^^^^^^^^.........##############################
#####################...########.........^^^^^^^^^^^^^^^^.........##############################
#####################...########..........^^^^^^^^^^^^^^^.........##############################
#####################...########.........^^^^^^^^^^^^^^^^.........##############################
#####################...########..............^^^^^^^.............##############################
#####################...########..............^^^^^^^.............##############################
#########.....................................^^^^^^^................................###########
#########.....................................^^^^^^^................................###########
#########.....................................^^^^^^^................................###########
#########.....................................^^^^^^^................................###########
#########.........................############^^^^^^^#########.......................###########
#########.........................############^^^^^^^#########.......................###########
#########.........................############^^^^^^^#########.......................###########
#########.....................................^^^^^^^................................###########
#########.....................................^^^^^^^................................###########
#########......................................^^^^^^................................###########
#########.........................############^^^^^^^#########.......................###########
#########.........................############^^^^^^^#########.......................###########
#########.........................############^^^^^^##########.......................###########
#########.........................############################.......................###########
#########.........................############################.......................###########
#########.........................############################.......................###########
####################...#################################################...#####################
####################...#################################################...#####################
####################...#################################################...#####################
####################...#################################################...#####################
####################...#################################################...#####################
####################...#################################################...#####################
####################...#################################################...#####################
####################...#################################################...#####################
####################...#################################################...#####################
####################...###########..............................########...#####################
####################...###########..............................########...#####################
####################...###########..............................########...#####################
####################...###########..............................########...#####################
####################...###########..............................########...#####################
####################.......................................................#####################
####################.......................................................#####################
#####################.....................................................######################
##################################..............................################################
##################################..............................################################
##################################..............<...............################################
##################################..............................################################
################################################################################################
################################################################################################
################################################################################################
################################################################################################
################################################################################################
################################################################################################
