################################################################################################
################################################################################################
################################################################################################
################################################################################################
################################################################################################
################################################################################################
#######.......................##################################################################
#######.......................##################################################################
#######.......................##################################################################
#######.......................##################################################################
#######.......................##################################################################
#######.......................##################################################################
#######.........>.............##################################################################
#######.......................##################################################################
#######.......................##################################################################
#######.......................##################################################################
#######.......................##################################################################
#######.......................##################################################################
#######.......................##################################################################
#######.......................##################################################################
#######.......................##################################################################
#######.......................##################################################################
#################...############################################..................##############
#################...############################################..................##############
#################...############################################..................##############
#################...############################################..................##############
#################...############################################..................##############
#################.................................................................##############
#################.................................................................##############
#################.................................................................##############
#################...############################################..................##############
#################...############################################..................##############
#################...############################################..................##############
#################...############################################..................##############
#################...####################################################...#####################
#################...####################################################...#####################
#################...####################################################...#####################
#################...####################################################...#####################
#################...####################################################...#####################
#################...####################################################...#####################
#################...####################################################...#####################
#################...############..~~~~~~.~~~~~~~~~~~~~~~~~#~~...########...#####################
#################...############..~~~~~~~~~~~~~~~~~~~~~~~~~~~...########...#####################
#################...############..~~~~~~~~~~~~~~~~~~~~~~~~~~~...########...#####################
#################...############..~~~~~~~~~~~~~~~~~~~~~~~~~~~...########...#####################
#################...########......~~~~~~~~~~~~~~~~~~~~~~~~~~~...########...#####################
#################...#######.......~~~~~~~~~~~~~~~~~~~~~~~~~~~...########...#####################
#################...#######.......~~~~~~~~~~~~~~~~~~~~~~~~~~~...########...#####################
#################...#######...##.#~~~~~~~~~~~~~~~~~~~~~~~~~~....########...#####################
#################...#######...###.~~~~~~~~~~~~~~~~~~~~~~~~~.~...########...#####################
#################...#######...##..~~~~~~.~~~~~~~~~~~~~~~~~#~~...########...#####################
#################...#######...#################...######################...#####################
#################...#######...#################...######################...#####################
#################...#######...#################...######################...#####################
#################...#######...#################...######################...#####################
#################..................#...##...#..........................#...#####################
#################......................##..#..........................#....#####################
#################......................##.#..........................#.....#####################
#################......................###.................................#####################
#################......................##..................................#####################
#################......................##..................................#####################
#################......................##..................................#####################
#################......................##..................................#####################
##################.....................##..................................#####################
##################.....................##..................................#####################
##################.....................##..................................#####################
##################.....................##..................................#####################
##################.....................##..................................#####################
##################....#................##..................................#####################
#########################################..................................#####################
#########################################..................................#####################
#########################################..................................#####################
#########################################..................................#####################
#########################################..................................#####################
#########################################..................................#####################
#########################################.#................................#####################
##########################################............................................#..#######
#########################################................................................#######
#########################################.......#........................................#######
#########################################......#.................#.......................#######
##########################################################...##########..................#######
##########################################################...##########..................#######
##########################################################......................<........#######
##########################################################...............................#######
###########################################################..............................#######
#######################################################################..................#######
#######################################################################..................#######
#######################################################################..................#######
#######################################################################..................#######
#######################################################################..#...............#######
################################################################################################
################################################################################################
################################################################################################
################################################################################################
################################################################################################
################################################################################################
