################################################################################################
################################################################################################
################################################################################################
################################################################################################
################################################################################################
################################################################################################
################################################################.......................#########
################################################################.......................#########
################################################################.......................#########
################################################################.......................#########
#######.....................####################################................>......#########
#######.....................####################################.......................#########
#######.....................####################################.......................#########
#######.....................####################################.......................#########
#######.....................####################################.......................#########
#######.....................####################################.......................#########
#######..................+............................................................#########
#######................................................................................#########
#######................................................................................#########
#######.....................####################################.......................#########
#######.....................####################################.......................#########
#######.....................####################################.......................#########
#######.....................##############################################...###################
#######.....................##############################################...###################
################...#######################################################...###################
################...#######################################################...###################
################...#######################################################...###################
################...#######################################################...###################
################...#######################################################...###################
################...#######################################################...###################
################...#######################################################...###################
################...#######################################################...###################
################...#######################################################...###################
################...###########################################.......................###########
################...###########################################.......................###########
#########.......................##############################.......................###########
#########.......................##############################.......................###########
#########.......................##############################.......................###########
#########.......................##############################.......................###########
#########.......................##############################.......................###########
#########.......................##############################.......................###########
#########.......................##############################.......................###########
#########.......................##############################.......................###########
#########.......................##############################.......................###########
#########.......................##############################.......................###########
#########.......................########################################...#####################
#########.......................########################################...#####################
#########.......................########################################...#####################
#########.......................########################################...#####################
###################...####################........#.................#........#..################
###################...###################...................................#...################
###################...###################..................................#....################
###################...###################.......................................################
###################...###################.......................................################
###################...###################.......................................################
###################...###################.......................................################
###################...###################.......................................################
###################.............................................................################
###################.............................................................################
####################............................................................################
#########################################.......................................################
#########################################.......................................################
#########################################.......................................################
#########.....................+........##.......................................################
#########..............................##...#...................................################
#########..............................##..#...................................#################
#########..............................##.#........#.................#........#.################
#########..............................####################...##################################
#########..............................####################...##################################
#########..............................####################...##################################
#########.....................................................##################################
#########.......................................................................################
#########.......................................................................################
#########..............................##################.......................################
#########..............................##################.......................################
#########..............................##################.......................################
#########..............................##################.........+.............################
#########..............................##################.......................################
#########..............................##################.......................################
#######################...###############################.......................################
#######################...###########...........................................################
#######################...###########...........................................################
#######################...###########...........................................################
#######################...###########.........................#####...##########################
#######################...###########.........................#####...##########################
#######################...............................................##########################
#######################...............................................##########################
########################.............................................###########################
#####################################...........<.............##################################
#####################################.........................##################################
#####################################.........................##################################
#####################################.........................##################################
################################################################################################
################################################################################################
################################################################################################
################################################################################################
