################################################################################################
################################################################################################
################################################################################################
################################################################################################
################################..................................##############################
################################..................................##############################
################################..................................##############################
################################..................................##############################
################################................>.................##############################
################################..................................##############################
################################..................................##############################
################################..................................##############################
################################..................................##############################
################################..................................##############################
################################..................................##############################
################################..................................##############################
################################..................................##############################
################################..................................##############################
################################################...#############################################
################################################...#############################################
#####################################.......................####################################
#####################################.......................####################################
#####################################.......................####################################
#####################################.......................####################################
#####################################.......................####################################
#####################################...........+...........####################################
#####################################.......................####################################
#####################################.......................####################################
#####################################.......................####################################
#####################################.......................####################################
###############################################...##############################################
###############################################...##############################################
###############################################...##############################################
#######.........................###############...##############################################
#######.........................###############...##############################################
#######..................................................................................#######
#######..................................................................................#######
#######..................................................................................#######
#######..................................................................................#######
#######..................................................................................#######
#######..................................................................................#######
#######..................................................................................#######
#######..................................................................................#######
#######..................................................................................#######
#######..................................................................................#######
#######.........................................................................B........#######
#######..................................................................................#######
#######..................................................................................#######
#######..................................................................................#######
##################...###########.........................................................#######
##################...###########.........................................................#######
##################...###########.........................................................#######
##################...###########.........................................................#######
#######...#.................#............................................................#######
#######..#.................#.............................................................#######
#######.#................................................................................#######
########................................................................................########
#######..................................................................................#######
#######..................................................................................#######
#######..................................................................................#######
#######..................................................................................#######
#######..................................................................................#######
#######..................................................................................#######
#######..................................................................................#######
#######..................................................................................#######
########................................................................................########
#######................................................................................#.#######
#######...............................................................................#..#######
#######......#.................#.....................................................#...#######
##################...###########.........................................#.....#################
##################...#####################################################.....#################
##################...#####################################################.....#################
##################...#####################################################.....#################
##################...#####################################################.....#################
##################...#####################################################.....#################
##################...#####################################################.....#################
##################...#####################################################.....#################
##################...#####################################################.....#################
##################...######...#..........................#........#.######.....#################
##################...######..#...................................#..######.....#################
##################...######.#.......................................######.....#################
##################...#######........................................######.....#################
##################...######....................................................#################
##################.............................................................#################
##################.............................................................#################
###################..........................................................###################
###########################..................................................###################
###########################.......................................#.############################
###########################..#..................<................#..############################
###########################.#........#..........................#...############################
################################################################################################
################################################################################################
################################################################################################
################################################################################################
################################################################################################
################################################################################################
