################################################
################################################
##########.........>.........###################
##########...................###################
#####........#######.#######...............#####
#####........#.....#.#.....#...............B####
#####........#.....#.#.....#...............#####
#####........#.....#.#.....#...............#####
#####........#######.#.#######.............#####
#####...............#.#....................#####
#####.....######....#.#....######..........#####
#####.....#....#....#.#....#....#..........######
#####.....#....#....#.#....#....#..........######
#####.....######....#.#....######..........######
#####...............#.#....................#####
#####........#######.#.#######.............#####
#####........#.....#.#.....#...............#####
#####........#.....#.#.....#...............#####
#####....<...#.....#.#.....#...............#####
#####........#######.#######...............#####
################################################
################################################
################################################
################################################
