################################################################################################
################################################################################################
################################################################################################
################################################################################################
################################################################################################
################################################################################################
################################################################################################
################################################################################################
#####################################################################.....................######
#####################################################################.....................######
###########......#................###################################.....................######
###########.......................###################################.....................######
###########......................####################################.............>.......######
###########.......................###################################.....................######
###########.....^^^^^^^^^^^^^^....###################################.....................######
###########.....^^^^^^^^^^^^^^....###################################.....................######
###########.....^^^^^^^^^^^^^^................................................+...........######
###########.....^^^^^^^^^^^^^^............................................................######
###########.....^^^^^^^^^^^^^^............................................................######
###########.....^.^^^^^^^^^^^^....###################################.....................######
###########.......................###################################.....................######
###########......................####################################.....................######
###########...#.................#.###################################.....................######
###########..#.................#..###################################.....................######
#####################...######################################################...###############
#####################...######################################################...###############
#####################...######################################################...###############
#####################...######################################################...###############
#####################...######################################################...###############
#####################...######################################################...###############
#####################...######################################################...###############
#########..............................####..................#################...###############
#########..............................####..................#################...###############
#########..............................####..................#####.....................#########
#########..............................####..................#####.....................#########
#########..............................####..................#####.....................#########
#########..............................####..................#####.....................#########
#########..............................####.......+....................................#########
#########..............................####............................................#########
#########..............................####............................................#########
#########..............................####..................#####.....................#########
#########..............................####..................#####.......+.............#########
#########..............................####..................#####.....................#########
#########..............................####..................#####.....................#########
#########..............................####..................#####.....................#########
#########..............................############...############.....................#########
#########..............................############...############.....................#########
#########..............................############...############.....................#########
#########..............................############...############.....................#########
#######################...###############+#########...##########################################
#######################...#########################...##########################################
#######################...#########################...##########################################
#######################...#########################...##########################################
#######################...#########################...##########################################
#######################...#########################...##########################################
#######################...#..............................................#######################
#######################...#..............................................#######################
#######################...#..............................................#######################
#######################...#..............................................#######################
#######################...#..............................................#######################
#######################...#..............................................#######################
#######################...#..............................................#######################
#######################...#..............................................#######################
#######################...#..............................................................#######
#######################..................................................................#######
#######################.................................................................########
########################.................................................................#######
###########################..............................................................#######
###########################..............................................................#######
###########################...................................................B..........#######
###########################..............................................................#######
###########################..............................................................#######
###########################..............................................................#######
###########################..............................................................#######
###########################.............................................................########
###########################............................................................#.#######
###########################...........................................................#..#######
###########################..............................................######...##############
#######....................................................................#......##############
#######...........................................................................##############
#######.....................###################...................................##############
#######.....................###################...................................##############
#######.....................###################...................................##############
#######...........................................................................##############
#######..........................................................................###############
#######.........................................................................################
#######.........<...........######################..........................#...################
#######.....................######################.......#.................#....################
#######.....................####################################################################
#######.....................####################################################################
################################################################################################
################################################################################################
################################################################################################
################################################################################################
################################################################################################
################################################################################################
